-15
16
-6
5
11111111111111111111111111111111
10000000000000000000111111100001
10000000000000100000111111100001
10000000000000100000111111100001
10000000000000000000111111100001
10000000000000000000111111100001
10000000000000000000111111100001
10001110000000000000111111100001
10001110000000000000000000000001
10001110000000000001000000000001
10000000000000000001000000000001
11111111111111111111111111111111
