-15
14
-6
4
111111111111111111111111111111
100000000000001000001111111001
100000000000001000001111111001
100000000000000000001111111001
100000000000000000001111111001
100000000000000000001111111001
100011100000000000001111111001
100011100000000000000000000001
100011100000000000010000000001
100000000000000000010000000001
111111111111111111111111111111
