-15
15
-6
5
0000000000000000000000000000000
1111111111111111111111111111110
1000000000000010000011111110010
1000000000000010000011111110010
1000000000000000000011111110010
1000000000000000000011111110010
1000000000000000000011111110010
1000111000000000000011111110010
1000111000000000000000000000010
1000111000000000000100000000010
1000000000000000000100000000010
1111111111111111111111111111110
