-11
13
-5
5
0000000000000000000000000
0000000000000000111111100
0000000000100000111111100
0000000000100000111111100
0000000000000000111111100
0000000000000000111111100
0000000000000000111111100
1110000000000000111111100
1110000000000000000000000
1110000000000001000000000
0000000000000001000000000
